f 000000000000000000000000000000000000000000000000000000000000000000000000000000000000000000000000000000000000000000000000000000000000000000000000000000000000000000000000000000000000000000000000000000000000000000000000000000000000000000000000000000000000000000000000000000000000000000000000000000000000
e 000000000000000000000000000000000000000000000000000000000000000000000000000000000000000000000000000000000000000000000000000000000000000000090000000000000000000000000900000000000000000000000000000000000000000000000000000000000000000000000000000000900000000000000000000000000000000000000000000000000000
d 000000000000000009000000000900000000000090000000000000090000000000009000000000000000000000090000000000000000000900000000000000000000900000000000000000090000000000000000000009000000000000000000090000000000000900000000000000000000900000000000000000000090000000000000000000090000000000000000090000000000
c 040679497499799949699994667999709006409797944796499770797909969999979400740676669994999479999697969764909694476949997099979676060904947749744706494099969779794779747767476697090999766979996999679999090799997999999494999907709967779079444690990994900699964696740677070990969096967976046969999999249476
b 777777777777777777777777777777777777777777777777777777777777777777777777777777777777777777777777777777777777777777777777777777777777777777777777777777777777777777777777777777777777777777777777777777777777777777777777777777777777777777777777777777777777777777777777777777777777777777777777777777777777
a 111111111111111111111111111111111111111111111111111111111111111111111111111111111111111111111111111111111111111111111111111111111111111111111111111111111111111111111111111111111111111111111111111111111111111111111111111111111111111111111111111111111111111111111111111111111111111111111111111111111111
