f 000000000000000000000000000000000000000000000000000000000000000000000000000000000000000000000000000000000000000000000000000000000000000000000000000000000000000000000000000000000000000000000000000000000000000000000000000000000000000000000000000000000000000000000000000000000000000000000000000000000000
e 000000000000000000000090000000000000000000000000000000000000000000090000000000000000000000000000000000000000000000000900000000000000000000000000000000000000000000000000000900000000000000000000000000000000000000000000090000000000000000000000000000000000000000000000000000000000000000000000000000000000
d 000000000000000000000000000000000000000000000000000000000000000000000000000000000000000000000000000000000000000000000000000000000000000000000000000000000000000000000000000000000000000000000000000000000000000000000000000000000000000000000000000000000000000000000000000000000000000000000000000000000000
c 090000479999049709797970096490690440949774904679907049004909907900497709007799474470909907090906949099709067669044099009707907977009999669979079400760699047997099964470994607900970400990060747070907996994009009949097000074047697744999099960690499799764744947400000000000000000000000000000000000000000
b 777777777777777777777777777777777777777777777777777777777777777777777777777777777777777777777777777777777777777777777777777777777777777777777777777777777777777777777777777777777777777777777777777777777777777777777777777777777777777777777777777777777777777777777777777777777777777777777777777777777777
a 111111111111111111111111111111111111111111111111111111111111111111111111111111111111111111111111111111111111111111111111111111111111111111111111111111111111111111111111111111111111111111111111111111111111111111111111111111111111111111111111111111111111111111111111111111111111111111111111111111111111
