f 00000000000000000000000000000000000000000000000000000000000444444444444444444444444444444444000000000000000044444444444444444444444000000000000000000000000000000444444444444444444444444
e 00000000000000000000000000000000000000000000000000000000000000000000000000000000000004444444444444444444444444444444444444444444444444444444444444444444444444444444444444444444444444444
d 00000000000000000000000000000000000000000000000000000000000000000000000004444444444444444444444444444444444444444444444444444444444444444444444444444444444444444444444444444444444444444
c 00000000000000000000000000000000000000000000000000000000000000000044444444444444444444444444444444444444444444444444444444444444444444444444444444444444444444444444444444444444444444444
b 77777777777777777777777777777777777777777777777777777777777777777777777777777777777777777777777777777777777777777777777777777777777777777777777777777777777777777777777777777777777777777
a 11111111111111111111111111111111111111111111111111111111111111111111111111111111111111111111111111111111111111111111111111111111111111111111111111111111111111111111111111111111111111111
