f 000000000000000000000000000000000000000000000000000000000000000000000000000000000000000000000000000000000000000000000000000000000000000000000000000000000000000000000000000000000000000000000000000000000000000000000000000000000000000000000000000000000000000000000000000000000000000000000000000000000000
e 000000040000000000000000000000000000000000000000000000000000000040000000000000000000000400000004404000000000000040000000000000000000004000000000000400000000000000000000000000400004000000000000000000000000000000000040000000000000400000000000004004000400400000000000000000000000000000000000000000000000
d 000409900049000007004990404009090900090000900099099000990070094900000090090400709900049099900749009000070400040790000409000000407900049909707009094009070900000000994900009000404090900994900009400077009090499000099000000904090979790009900909490009000000490094000000000000000000000000000000000000000000
c 704079099909907499007004707794794007704404700907097970990090000040479000490900409900990094470009904000909449004974747700700497709000790909099404490040009407709009994000400970900470074979099904007097009004970499099940009490474770704000007009907794000000700447900000000000000000000000000000000000000000
b 777777777777777777777777777777777777777777777777777777777777777777777777777777777777777777777777777777777777777777777777777777777777777777777777777777777777777777777777777777777777777777777777777777777777777777777777777777777777777777777777777777777777777777777777777777777777777777777777777777777777
a 111111111111111111111111111111111111111111111111111111111111111111111111111111111111111111111111111111111111111111111111111111111111111111111111111111111111111111111111111111111111111111111111111111111111111111111111111111111111111111111111111111111111111111111111111111111111111111111111111111111111
