f 000000000000000000000000000000000000000000000000000000000000000000000000000000000000000000000000000000000000000000000000000000000000000000000000000000000000000000000000000000000000000000000000000000000000000000000000000000000000000000000000000000000000000000000000000000000000000000000000000000000000
e 000000000000004000000000000000000000400000000000000000000000000000000000000000000000000000000000004000000000400000000000000000040000000000000000000000000040000000004000000000000000000000000000000000000000000000000000000400000000000000000000000000000000000000000000000000400000000000000000000000000000
d 000709070090000000009000000090000909009009909000049000000900000049090900000009099007000090077000909990000000049490007000909977774970000090970009000099909007049940997009009097090099000000090009909900900909909400900000094000990000900909000707000900904990000900099000090970900000000000000000000000000000
c 400979009499400940497000749799970700900749949477000090040909094490090709997470744007790907400404000990049909099097090979900900700979979499990090900707499079900479700000790700909079777970700909470000799990770044907900009999790090097070770404990070094909790790070799000094070090000000000000000000000000
b 777777777777777777777777777777777777777777777777777777777777777777777777777777777777777777777777777777777777777777777777777777777777777777777777777777777777777777777777777777777777777777777777777777777777777777777777777777777777777777777777777777777777777777777777777777777777777777777777777777777777
a 111111111111111111111111111111111111111111111111111111111111111111111111111111111111111111111111111111111111111111111111111111111111111111111111111111111111111111111111111111111111111111111111111111111111111111111111111111111111111111111111111111111111111111111111111111111111111111111111111111111111
