f 00000000000000000000000000000000000000000000000000000000000000000000000000000000000000000000000000000000000000000000000000000000000000000000000000000000000000000000000000000000000000000000000000000000000000000000000000000000000000000000000000000000000000000000000000000000000000000000000000000000000000000000000000000000000000000000000000000000000000000000000000000000000000000000000000000000000
e 00000000000000000000000000000007000000000000000040000000000400000000000000000000000000400000000000000000000000000040000000000000000000400000000000000040000000000000010000000000000000000000000000000000000000000000000000000000000000000000000000000000044000000000000044000000000004400000000000000000000000000000040000000000000000000040000000000000000000000000000400000000000000000040000000000000000
d 00000000000000000000000000000001000000000004000000000000000000000000000000000000000000000000000000000000000000004000000000000000000040000000000000400000000000000000000000000000000000040000000000000000004000000000000000000000000040000000000000000000000000000000000000000000000000000000000000000000000000000000000000000000000000000000000000000000000000000000000000000000001000000000000000000000000
c 00000000000000000000000000000000000000000000000000000000070000000000000000000000000000000000000070000000000000000000000000000000000000000000000000000000000000000000000000000000000000000000000000000000000007000000000000000000000000000000000000000000000000000000000000000000000000000000000000000000000000000000000000000000000000000000000000000000000000000000000000000000000000000000000000000000000
b 77777777777777777777777777777777777777777777777777777777717777777777777777777777777777777777777717777777777777777777777777777777777777777777777777777777777777777777777777777777777777777777777777777777777771777777777777777777777777777777777777777777777777777777777777777777777777777777777777777777777777777777777777777777777777777777777777777777777777777777777777777777777777777777777777777777777
a 11111111111111111111111111111111111111111111111111111111111111111111111111111111111111111111111111111111111111111111111111111111111111111111111111111111111111111111111111111111111111111111111111111111111111111111111111111111111111111111111111111111111111111111111111111111111111111111111111111111111111111111111111111111111111111111111111111111111111111111111111111111111111111111111111111111111
