f 000000000000000000000000000000000000000000000000000000000000000000000000000000000000000000000000000000000000000000000000000000000000
e 000000000000000004000100000000000000000000000000000000000000000000000000000000000000000000000000000000000000000000000000000000000000
d 000000000000000000047100000000000000000000000000000000000000000000000000000000000000000000000000000000000000000000000000000000000000
c 000000040070000400000004000000004000000000000000000000000000000000000000000000000000000000000000000000000000000000000000000000000000
b 777777777777777777777777777777777777777777777777777777777777777777777777777777777777777777777777777777777777777777777777777777777777
a 111111111111111111111111111111111111111111111111111111111111111111111111111111111111111111111111111111111111111111111111111111111111
