f 0000000000000000000009000000000000000000000000000000000000000000079497000000000000000000000900000000090000000000000000000000000000000000000000000000000090000090000000000000000000000079970000009000090000000777770777700000000000000000000000000090000009000000000000900000000000000900000000000000000
e 0000009000000900040001000000000000000000000000000000000000000000007770000000000000000000000704490040070000000000000000000000000000000000000000000000000070040070000000000000000000000019910000000000000000000799999999100000000000000000000000000000000000000000009000700000000000000900000000000000000
d 0000000000900000000471000000000000000000000000000000000000000000000000000000000000000000000177777777710000000000000000000000000009004400000000000000000077777770000000000000004000000019910000000400000000000700000000100000000040000000000000040000000000004000007000700040000000000900000000000000000
c 0000000400700004000000040000000040000007704097700000000000000000740400700000000044400000007111111111117000000000000000000000000777770000000000000000400000000000004000000700000000000014410000000000000000700100044440107000077977000000000000000000000000000000007007700044700604400700000020000000000
b 7777777777777777777777777777777777777771177771177777777777777777777777777777777777777777771777777777771777777777777777777777777777777777777777777777777777777777777777777177777777777777777777777777777777177177777777771777711711777777777777777777777777777777777777777777177777777177777777777777777
a 1111111111111111111111111111111111111111111111111111111111111111111111111111111111111111111111111111111111111111111111111111111111111111111111111111111111111111111111111111111111111111111111111111111111111111111111111111111111111111111111111111111111111111111111111111111111111111111111111111111
