f 000000000000000000000000000000000000000000000000000000000000000000000000000000000000000000000000000000000000000000000000000000000000000000000000000000000000000000000000000000000000000000000000000000000000000000000000000000000000000000000000000000000000000000000000000000000000000000000000000000000000
e 000000000000000090000000000000000000000090000000000000000000000009000000000000000000000000000090000000000000000000000000000000000090000000000000000000000000000000000000000000000009000000000000000000000000000000000000009000000000000000000000000000000000000000000400000000000000000000000000000000000000
d 000000000000000000000000000000000000000000000000000000000000000000000000000000000000000000000000000000000000000000000000000000000000000000000000000000000000000000000000000000000000000000000000000000000000000000000000000000000000000000000000000000000000000000000000000000000000000000000000000000000000
c 070000940999607009647449694900070047097474700990740999400490979979067049470900709490999970040099979470704990000049090960996070990077400004904909477007099090009404009990997766047747009004094070099947790940009779704009690494999607760409999794009449000009090090000900700000000000000000000000000000000000
b 777777777777777777777777777777777777777777777777777777777777777777777777777777777777777777777777777777777777777777777777777777777777777777777777777777777777777777777777777777777777777777777777777777777777777777777777777777777777777777777777777777777777777777777777777777777777777777777777777777777777
a 111111111111111111111111111111111111111111111111111111111111111111111111111111111111111111111111111111111111111111111111111111111111111111111111111111111111111111111111111111111111111111111111111111111111111111111111111111111111111111111111111111111111111111111111111111111111111111111111111111111111
