f 0000000000000000000000000000000000000000000000000000000000000000000000000000000000000000000000000000000000000000000000000000000000000000000000000000000000000000000000000000000000000000000000000000000000000000000000000000000000000000000000000000000000000000000000000000000000000000000000000000000
e 0000009000000900040001000000000000000000000000000000000000000000000000000000000000000000000000000000000000000000000000000000000000000000000000000000000000000000000000000000000000000000000000000000000000000000000000000000000000000000000000000000000000000000000000000000000000000000000000000000000
d 0000000000900000000471000000000000000000000000700000000000000000000000000000000000000000000000000000000000000000000000000000000000004400000000000000000000000000000000000000040000000000000000004000000000000000000004000000000004000000000000004000000000000400000000000400000000004000000000000000000
c 000000040070060400060004000006004000007700007100000000000000000000000000000000000000000000000000000000000000000000000000000000000000000000000000000000000000000000000000100000000000000000000000000000000100000000000001000011011000000000000000000000000000000000000000000000000000100000000000000000
b 7777777777777777777777777777777777777771177771177777777777777777777777777777777777777777777777777777777777777777777777777777777777777777777777777777777777777777777777777177777777777777777777777777777777177777777777771777711711777777777777777777777777777777777777777777777777777177777777777777777
a 1111111111111111111111111111111111111111111111111111111111111111111111111111111111111111111111111111111111111111111111111111111111111111111111111111111111111111111111111111111111111111111111111111111111111111111111111111111111111111111111111111111111111111111111111111111111111111111111111111111
