f 0000000000000000000000000000000000000000000000000000000000044444444444444444444444444444444400000000000000004444444444444444444444400000000000000000000000000000044444444444444444444444444444444444400000000000000000000000000000000004444444444444444444444444444444444444444444444444000000000000000000000444444444444444444444444444440000000000000
e 0000000000000000000000000000000000000000000000000000000000000000000000000000000000000444444444444444444444444444444444444444444444444444444444444444444444444444444444444444444444444444444444444444440000000000000000000000000000000000000444444444444444444444444444444444444444444444444000000000000000000000000000000000000044444444444444444444444
d 0000000000000000000000000000000000000000000000000000000000000000000000000444444444444444444444444444444444444444444444444444444444444444444444444444444444444444444444444444444444444444444444444444444444444444444444444444444444444444444444444444444444444444444444444444444444444444444444444444444444444444444444444444444444444444444444444444444
c 0000000000000000000000000000000000000000000000000000000000000000004444444444444444444444444444444444444444444444444444444444444444444444444444444444444444444444444444444444444444444444444444444444444444444444444444444444444444444444444444444444444444444444444444444444444444444444444444444444444444444444444444444444444444444444444444444444444
b 7777777777777777777777777777777777777777777777777777777777777777777777777777777777777777777777777777777777777777777777777777777777777777777777777777777777777777777777777777777777777777777777777777777777777777777777777777777777777777777777777777777777777777777777777777777777777777777777777777777777777777777777777777777777777777777777777777777
a 1111111111111111111111111111111111111111111111111111111111111111111111111111111111111111111111111111111111111111111111111111111111111111111111111111111111111111111111111111111111111111111111111111111111111111111111111111111111111111111111111111111111111111111111111111111111111111111111111111111111111111111111111111111111111111111111111111111
