f 000000000000000000000000000000000000000000000000000000000000000000000000000000000000000000000000000000000000000000000000000000000000000000000000000000000000000000000000000000000000000000000000000000000000000000000000000000000000000000000000000000000000000000000000000000000000000000000000000000000000
e 004000000000000040000000000000000000000000000000040000040000400000000000040000004000040000004040000000000400000000400004000000040000440000000000000040000000000000000040040000000400040000000000040000000000000004000040000000040404000004040400440000000400044000000000000000000000000000000000000000000000
d 704940090900097009090090004409707009099900409990909909099040079070000940904009004000440900090440049097494000474799999404097999904079409049000900070009000040099049009907900940400090409909090709904049079004099000909900000400909997004090000070907094700009904944904990009007400000000000000000000000000000
c 090704000709909094009499700494749444900974007904900709407470070794744997099070900907949499490094000999040997070000700049944740049794094079979999000094904940779000404007709400799490040979990790907940009449990070079040799900099907949000090099004700099440407799077790477004000000000000000000000000000000
b 777777777777777777777777777777777777777777777777777777777777777777777777777777777777777777777777777777777777777777777777777777777777777777777777777777777777777777777777777777777777777777777777777777777777777777777777777777777777777777777777777777777777777777777777777777777777777777777777777777777777
a 111111111111111111111111111111111111111111111111111111111111111111111111111111111111111111111111111111111111111111111111111111111111111111111111111111111111111111111111111111111111111111111111111111111111111111111111111111111111111111111111111111111111111111111111111111111111111111111111111111111111
