f 999999999999999999999999999999999999999999999999999999999999999999999999999999999999999999999999999999999999999999999999999999999999
e 999999999999999994999199999999999999999999999999999999999999999999999999999999999999999999999999999999999999999999999999999999999999
d 999999999999999999947199999999999999999999999999999999999999999999999999999999999999999999999999999999999999999999999999999999999999
c 999999949979999499999994999999994999999999999999999999999999999999999999999999999999999999999999999999999999999999999999999999999999
b 777777777777777777777777777777777777777777777777777777777777777777777777777777777777777777777777777777777777777777777777777777777777
a 111111111111111111111111111111111111111111111111111111111111111111111111111111111111111111111111111111111111111111111111111111111111
