f 000000000000000000000000000000000000000000000000000000000000000000000000000000000000000000000000000000000000000000000000000000000000000000000000000000000000000000000000000000000000000000000000000000000000000000000000000000000000000000000000000000000000000000000000000000000000000000000000000000000000
e 000000000000000000000000900000000000000090000000000000000000000000000000000000000000000000000000000000000000000090000000000000000000000000000000000000000000000000000000000009000000000000000000000000000000000000000900000000000000000000000000000000000000000000000000000000000090000000000000000000000000
d 000000000000000000000000000000000000000000000000000000000000000000000000000000000000000000000000000000000000000000000000000000000000000000000000000000000000000000000000000000000000000000000000000000000000000000000000000000000000000000000000000000000000000000000000000000000000000000000000000000000000
c 097940964907770074797747690790700974996006099794007977079999960997974994099090000799994779009000009477069977997904777000907479777479670090009409004009040060099074077900007907090497990900990004497000640770070944479097774699670990990040907996979407999794497000000000000000000000000000000000000000000000
b 777777777777777777777777777777777777777777777777777777777777777777777777777777777777777777777777777777777777777777777777777777777777777777777777777777777777777777777777777777777777777777777777777777777777777777777777777777777777777777777777777777777777777777777777777777777777777777777777777777777777
a 111111111111111111111111111111111111111111111111111111111111111111111111111111111111111111111111111111111111111111111111111111111111111111111111111111111111111111111111111111111111111111111111111111111111111111111111111111111111111111111111111111111111111111111111111111111111111111111111111111111111
