f 100000000000100000000000000000000000000000000000000000000000000000000000000000000000000000000000000000000000000000000000000000000000
e 010000000000000100000000000000000000000000000000000000000000000000000000000000000000000000000000000000000000000000000000000000000000
d 001000000100000000000000000000000000000000000000000000000000000000000000000000000000000000000000000000000000000000000000000000000000
c 100011000000000000001000000000000000000000000000000000000000000000000000000000000000000000000000000000000000000000000000000000000000
b 111111111111111111111111111111111111111111111111111111111111111111111111111111111111111111111111111111111111111111111111111111111111
a 111111111111111111111111111111111111111111111111111111111111111111111111111111111111111111111111111111111111111111111111111111111111
